AE|United Arab Emirates
AL|Albania
AS|Asia
AT|Austria
AU|Australia
BA|Bosnia and Herzegovina
BE|Belgium
BG|Bulgaria
BR|Brazil
CA|Canada
CH|Switzerland
CL|Chile
CN|China
CS|Serbia and Montenegro
CY|Cyprus
CZ|Czech Republic
DE|Germany
DK|Denmark
EE|Estonia
EG|Egypt
ES|Spain
EU|Europe
FI|Finland
FR|France
GB|United Kingdom
GR|Greece
HK|Hong Kong
HR|Croatia
HU|Hungary
ID|Indonesia
IE|Ireland
IL|Israel
IN|India
IR|Iran
IS|Iceland
IT|Italy
JO|Jordan
JP|Japan
KR|Korea
KR|South Korea
LT|Lithuania
LU|Luxembourg
LV|Latvia
MN|Mongolia
MX|Mexico
MY|Malaysia
NL|Netherlands
NO|Norway
NP|Nepal
NZ|New Zealand
OM|Oman
PE|Peru
PH|Philippines
PL|Poland
PT|Portugal
QA|Qatar
RO|Romania
RU|Russia
SE|Sweden
SG|Singapore
SI|Slovenia
SK|Slovakia
TH|Thailand
TR|Turkey
TW|Taiwan
US|United States
USA|United States
VN|Vietnam
YU|Yugoslavia
ZA|South Africa
World|World
Europe|Europe
Asia|Asia
