ar|Arabic
bg|Bulgarian
bs|Bosnian
cs|Czech
cy|Welsh
da|Danish
de|German
el|Greek
en|English
eo|Esperanto
es|Spanish
et|Estonian
fa|Persian
fi|Finnish
fr|French
fr-ca|French Canadian
ga|Irish
gd|Gaelic
gu|Gujarati
he|Hebrew
hi|Hindi
hr|Croatian
hu|Hungarian
is|Icelandic
it|Italian
ja|Japanese
ko|Korean
lt|Lithuanian
lv|Latvian
ms|Malay
nl|Dutch
no|Norwegian
pl|Polish
pt|Portuguese
ro|Romanian
ru|Russian
sk|Slovakian
sl|Slovenian
sq|Albanian
sr|Serbian
sv|Swedish
th|Thai
tr|Turkish
ur|Urdu
vi|Vietnamese
yi|Yiddish
zh|Chinese
